########################################
#P  ##                                 #
#    #                            #    #
# #                     #              #
#                                      #
#        #                             #
#                   #           #      #
#                                      #
#         ####                         #
##                       #             #
#            #                         #
#                             #        #
#      ##  #                           #
#                                      #
#                  L         ####      #
#      #                               #
#                  ####                #
#     #                                #
#                                      #
#                               #      #
#      #         # #                   #
#                                      #
#                        #  #          #
#      #    #      #      C            #
#                              #       #
#         #                            #
#                                      #
#                  S         #         #
#     #                                #
########################################