#######################################
#                                     #
#                                     #
#                                     #
#                            L        #
#                                     #
#                                     #
#                                     #
#                                     #
#        ###                          #
#                                     #
#                                     #
#                                     #
#                                     #
#                  #                  #
#                  #                  #
#                  #                  #
#                                     #
#                                     #
#                                     #
#                                     #
#                                     #
#                                     #
#                                     #
#                                 P   #
#                                     #
#                                     #
#                                     #
#                                     #
#######################################