########################################
#                                      #
#                                 #    #
# #                      #             #
#                                      #
#        #                             #
#                               #      #
#                                      #
#         #                            #
##                       #             #
#                                      #
#                             #        #
#      #                               #
#                                      #
#                  L            #      #
#      #                               #
#                     #                #
#            #                         #
#                                      #
#                               #      #
#      #         #                     #
#                                      #
#                           #          #
#                  #                   #
#                                      #
#         #    S                       #
#                                P     #
#                            #         #
#     #                                #
########################################